"Works on computer systems and software"	IT
"Handles employee recruitment and training"	HR
"Oversees sales strategy and customer relations"	Sales
"Manages network infrastructure and security"	IT
"Organizes company events and communications"	HR
"Negotiates with clients and closes deals"	Sales
"Analyzes company financial statements and prepares reports"	Finance
"Manages the payroll and employee compensation"	HR
"Provides support for accounting and budget management"	Finance
"Supervises supply chain operations and inventory management"	Operations
"Coordinates customer orders and deliveries"	Operations
"Maintains server uptime and data backups"	IT
"Provides financial advice to upper management"	Finance
"Leads the production of goods and ensures quality standards"	Operations
"Develops marketing strategies and customer outreach plans"	Sales
"Responsible for tax reporting and compliance"	Finance
"Manages the hiring and termination processes"	HR
"Troubleshoots technical issues and provides IT support"	IT
"Oversees the procurement of goods and services"	Operations
"Prepares monthly financial forecasts and budgets"	Finance
"Trains the sales team on new products and sales tactics"	Sales
"Ensures employee safety protocols are followed"	HR
"Builds and maintains the company's online infrastructure"	IT
"Handles accounts receivable and payable"	Finance
"Monitors daily factory operations and workforce management"	Operations
"Leads the sales team to meet company targets"	Sales
"Organizes leadership training and employee development programs"	HR
"Manages software installations and configurations"	IT
"Develops procedures to improve operational efficiency"	Operations
"Responsible for financial audits and risk management"	Finance
"Designs and maintains company websites"	IT
"Manages employee performance reviews and appraisals"	HR
"Handles international sales negotiations"	Sales
"Ensures cybersecurity compliance and monitoring"	IT
"Develops internal communication strategies"	HR
"Builds customer relationships to generate repeat business"	Sales
"Prepares annual financial statements for audit"	Finance
"Manages employee benefits and wellness programs"	HR
"Assists in budget planning for department heads"	Finance
"Ensures quality control across production lines"	Operations
"Coordinates shipping and receiving logistics"	Operations
"Manages cloud infrastructure and virtualization"	IT
"Assesses financial risks for investment decisions"	Finance
"Supervises production scheduling and workflow"	Operations
"Leads client presentations and product demos"	Sales
"Ensures compliance with labor laws and regulations"	HR
"Performs server maintenance and troubleshooting"	IT
"Manages vendor contracts and service agreements"	Operations
"Prepares variance reports and financial analysis"	Finance
"Develops marketing campaigns for product launches"	Sales
"Oversees employee health and safety initiatives"	HR
"Develops custom software for internal use"	IT
"Monitors equipment and supply chain metrics"	Operations
"Reviews financial statements for discrepancies"	Finance
"Leads competitive analysis and market research"	Sales
"Manages onboarding and orientation programs"	HR
"Implements network security policies and protocols"	IT
"Coordinates logistics for large-scale company events"	Operations
"Manages cash flow and liquidity planning"	Finance
"Leads cross-functional sales projects"	Sales
"Oversees recruitment of seasonal employees"	HR
"Maintains IT hardware and peripherals"	IT
"Plans supply chain capacity based on forecasts"	Operations
"Analyzes cost-saving opportunities across departments"	Finance
"Leads digital marketing and social media strategy"	Sales
"Develops diversity and inclusion initiatives"	HR
"Manages disaster recovery plans for IT systems"	IT
"Oversees warehouse operations and fulfillment"	Operations
"Prepares tax filings and ensures compliance"	Finance
"Leads sales pitches for large enterprise clients"	Sales
"Coordinates employee performance improvement plans"	HR
"Builds automation scripts for system monitoring"	IT
"Monitors supplier performance and delivery schedules"	Operations
"Prepares quarterly financial reports for management"	Finance
"Manages CRM systems and customer databases"	Sales
"Handles employee relations and conflict resolution"	HR
"Develops and maintains network architecture"	IT
"Monitors production efficiency and output levels"	Operations
"Assists with mergers and acquisitions due diligence"	Finance
"Oversees channel sales partnerships"	Sales
"Administers employee leave and time-off requests"	HR
"Implements data encryption and security protocols"	IT
"Supervises packaging and shipping teams"	Operations
"Analyzes investment opportunities for company growth"	Finance
"Manages trade show and exhibition logistics"	Sales
"Manages labor law compliance and audits"	HR
"Develops mobile apps for internal operations"	IT
"Monitors supply chain risks and contingencies"	Operations
"Prepares investment portfolios and financial models"	Finance
"Trains sales team on lead generation techniques"	Sales
"Develops succession planning and leadership programs"	HR
"Monitors server logs for performance issues"	IT
"Optimizes production schedules to minimize downtime"	Operations
"Prepares financial statements for quarterly earnings"	Finance
"Oversees regional sales team operations"	Sales
"Develops employee engagement and satisfaction surveys"	HR
"Implements cloud-based security infrastructure"	IT
"Monitors daily production quotas and outputs"	Operations
"Conducts internal audits to ensure financial compliance"	Finance
"Leads sales training sessions on customer engagement"	Sales
"Administers employee disciplinary actions and follow-up"	HR
"Troubleshoots networking and connectivity issues"	IT
"Supervises the procurement of raw materials"	Operations
"Prepares cash flow forecasts for strategic planning"	Finance
"Manages client relationships and contract renewals"	Sales
"Develops programs for employee skill development"	HR
"Oversees IT project implementations and upgrades"	IT
"Ensures continuous improvement in production processes"	Operations
"Conducts financial analysis to support business decisions"	Finance
"Leads initiatives for sales pipeline management"	Sales
"Designs and administers employee training programs"	HR
"Maintains company-wide databases and storage solutions"	IT
"Manages supplier contracts and delivery schedules"	Operations
"Reviews monthly financial performance metrics"	Finance
"Coordinates pricing strategies for sales campaigns"	Sales
"Ensures compliance with employee confidentiality policies"	HR
"Develops business intelligence dashboards for IT"	IT
"Manages real-time inventory tracking systems"	Operations
"Assesses financial feasibility of new business ventures"	Finance
"Leads strategic sales initiatives to enter new markets"	Sales
"Manages workforce planning and headcount forecasting"	HR
"Troubleshoots data breaches and implements fixes"	IT
"Oversees day-to-day operations of manufacturing plants"	Operations
"Prepares financial models for capital investment decisions"	Finance
"Leads sales presentations for high-value contracts"	Sales
"Coordinates employee reward and recognition programs"	HR
"Develops software for data analysis and reporting"	IT
"Manages logistics for incoming and outgoing shipments"	Operations
"Oversees financial audits for compliance purposes"	Finance
"Plans product promotions and special offers"	Sales
"Develops employee retention and incentive programs"	HR
"Implements IT automation to reduce manual tasks"	IT
"Monitors operational budgets and performance metrics"	Operations
"Analyzes the cost structure to identify efficiency gains"	Finance
"Manages client acquisition strategies for new business"	Sales
"Handles employee grievances and mediates disputes"	HR
"Manages IT support for office and remote employees"	IT
"Coordinates production line upgrades and process changes"	Operations
"Develops financial strategies for long-term growth"	Finance
"Leads sales training on objection handling and closing"	Sales
"Administers payroll and employee benefits"	HR
"Maintains company IT infrastructure and cybersecurity"	IT
"Manages global supply chain logistics and distribution"	Operations
"Analyzes profit margins and recommends adjustments"	Finance
"Manages partnerships and sponsorship sales deals"	Sales
"Leads talent acquisition and retention initiatives"	HR
"Develops scripts for network monitoring and management"	IT
"Monitors assembly line efficiency and process flows"	Operations
"Performs due diligence for major financial transactions"	Finance
"Oversees sales territory management and assignments"	Sales
"Ensures compliance with workplace diversity policies"	HR
"Develops and tests disaster recovery plans"	IT
"Manages raw materials procurement and stock levels"	Operations
"Prepares tax reports for local and international compliance"	Finance
"Leads sales efforts for new market entries"	Sales
"Manages employee records and HR documentation"	HR
"Ensures high availability of servers and databases"	IT
"Develops strategies for continuous operational improvement"	Operations
"Reviews financial statements for accuracy and compliance"	Finance
"Leads negotiations for high-stakes sales contracts"	Sales
"Handles employee disciplinary procedures and appeals"	HR
"Oversees network security audits and risk assessments"	IT
"Optimizes manufacturing workflow and staffing schedules"	Operations
"Prepares annual budgets for financial planning"	Finance
"Manages global sales partnerships and client outreach"	Sales
"Handles employee onboarding and cultural integration"	HR
"Implements virtualization and cloud-based solutions"	IT
"Supervises shipping, receiving, and warehouse operations"	Operations
"Conducts financial risk assessments and mitigation plans"	Finance
"Leads customer loyalty and retention programs"	Sales
"Develops employee handbooks and company policies"	HR
"Oversees IT systems administration and upgrades"	IT
"Manages just-in-time inventory and supply chain processes"	Operations
"Prepares financial forecasts for strategic decision-making"	Finance
"Leads high-level negotiations with potential clients"	Sales
"Handles sensitive employee data and ensures privacy compliance"	HR
"Develops and deploys scalable web applications"	IT
"Coordinates logistics for international shipments"	Operations
"Conducts financial due diligence for business acquisitions"	Finance
"Manages digital sales channels and e-commerce strategies"	Sales
"Administers employee pension and retirement plans"	HR
"Monitors cybersecurity threats and mitigates risks"	IT
"Oversees quality assurance for production operations"	Operations
"Prepares annual financial reports for shareholder meetings"	Finance
"Leads multi-channel marketing and sales campaigns"	Sales
"Oversees employee compensation and benefits reviews"	HR
"Develops AI-driven solutions for business automation"	IT
"Coordinates production and delivery schedules to meet demand"	Operations
"Performs internal audits to identify financial discrepancies"	Finance
"Leads sales initiatives to drive revenue growth"	Sales
"Handles recruitment for senior leadership positions"	HR
"Oversees server installations and cloud migrations"	IT
"Monitors software deployment and user access management"	IT
"Develops employee satisfaction surveys and action plans"	HR
"Leads sales presentations to key business clients"	Sales
"Handles investment portfolio management and reporting"	Finance
"Oversees IT equipment procurement and vendor relations"	IT
"Manages workforce diversity and inclusion programs"	HR
"Monitors sales KPIs and performance benchmarks"	Sales
"Prepares quarterly and annual tax filings"	Finance
"Administers internal communication platforms"	IT
"Coordinates employee recruitment fairs and career events"	HR
"Develops pricing models for new product launches"	Sales
"Reviews financial reports for investment planning"	Finance
"Implements security policies for mobile devices"	IT
"Manages employee assistance and wellness programs"	HR
"Oversees digital marketing and email campaigns"	Sales
"Performs cash flow analysis for operational efficiency"	Finance
"Develops APIs and backend infrastructure"	IT
"Administers employee benefits and compensation reviews"	HR
"Monitors competitor pricing strategies and trends"	Sales
"Leads financial reporting for government compliance"	Finance
"Builds and manages internal cloud-based systems"	IT
"Coordinates the recruitment process for junior positions"	HR
"Analyzes market data to improve sales performance"	Sales
"Prepares detailed financial statements for investors"	Finance
"Ensures network stability and infrastructure security"	IT
"Develops leadership training programs for managers"	HR
"Leads B2B sales efforts and strategic partnerships"	Sales
"Manages accounts payable and accounts receivable"	Finance
"Oversees IT system updates and user training"	IT
"Coordinates employee exit interviews and feedback"	HR
"Manages customer service strategy and implementation"	Sales
"Prepares financial projections for business growth"	Finance
"Implements IT help desk support processes"	IT
"Develops onboarding materials for new employees"	HR
"Coordinates sales territory assignments and coverage"	Sales
"Analyzes budget variances and operational costs"	Finance
"Develops cybersecurity protocols for data protection"	IT
"Leads employee performance improvement initiatives"	HR
"Develops CRM workflows for customer tracking"	Sales
"Prepares budget forecasts for departmental spending"	Finance
"Oversees deployment of enterprise-wide software"	IT
"Administers employee dispute resolution processes"	HR
"Coordinates international sales operations"	Sales
"Performs risk analysis for financial investments"	Finance
"Develops automated systems for data backup"	IT
"Ensures compliance with employee data protection laws"	HR
"Manages customer feedback and satisfaction programs"	Sales
"Reviews financial statements for audit compliance"	Finance
"Monitors application performance and user experiences"	IT
"Develops internal training manuals and resources"	HR
"Analyzes market trends to adjust sales tactics"	Sales
"Prepares regulatory filings and financial disclosures"	Finance
"Implements server virtualization and cloud management"	IT
"Manages HR policies on employee conduct and ethics"	HR
"Oversees outbound sales calls and customer acquisition"	Sales
"Prepares cash flow statements and budget allocations"	Finance
"Monitors IT system performance and efficiency"	IT
"Coordinates team-building and employee engagement activities"	HR
"Leads sales strategy for new product offerings"	Sales
"Analyzes cash flow trends for operational decision-making"	Finance
"Develops disaster recovery plans for IT infrastructure"	IT
"Handles employee relations for global teams"	HR
"Monitors sales team performance and quotas"	Sales
"Conducts financial analysis for cost-cutting initiatives"	Finance
"Develops and implements database management systems"	IT
"Manages compliance with labor laws and safety regulations"	HR
"Develops marketing collateral for sales presentations"	Sales
"Prepares investment strategies and recommendations"	Finance
"Designs scalable software architecture for the company"	IT
"Oversees recruiting for technical roles and specialists"	HR
"Manages client onboarding and account setup"	Sales
"Monitors financial transactions for accuracy and compliance"	Finance
"Troubleshoots network issues and configures firewalls"	IT
"Ensures compliance with employee training requirements"	HR
"Oversees sales channel development and optimization"	Sales
"Develops financial planning strategies for risk management"	Finance
"Implements network security protocols and audits"	IT
"Manages internal HR communications and policy updates"	HR
"Monitors e-commerce sales and digital customer experience"	Sales
"Prepares financial analysis reports for executive review"	Finance
"Develops and maintains software for internal use"	IT
"Coordinates employee career development programs"	HR
"Manages the sales pipeline for new leads and opportunities"	Sales
"Performs financial forecasting for new investments"	Finance
"Maintains secure data storage and cloud backups"	IT
"Oversees the onboarding process for remote employees"	HR
"Analyzes customer buying patterns and sales trends"	Sales
"Conducts internal audits to ensure financial accuracy"	Finance
"Develops automated scripts for network monitoring"	IT
"Handles conflict resolution between employees and management"	HR
"Oversees sales strategies for key client accounts"	Sales
"Prepares financial models for long-term planning"	Finance
"Monitors web traffic and server performance metrics"	IT
"Coordinates HR initiatives for workforce development"	HR
"Manages digital ad campaigns to drive sales growth"	Sales
"Conducts financial performance reviews for departments"	Finance
"Leads IT support and troubleshooting for all users"	IT
"Administers benefits and wellness programs for employees"	HR
"Develops customer engagement strategies for sales teams"	Sales
"Oversees financial planning for capital expenditures"	Finance
"Manages cybersecurity training for staff and contractors"	IT
"Handles legal compliance for employee policies and contracts"	HR
"Leads strategic sales initiatives to boost revenue"	Sales
"Monitors operating expenses and prepares budget reports"	Finance
"Develops automation solutions to improve IT efficiency"	IT
"Manages employee onboarding for international teams"	HR
"Develops sales proposals for high-value clients"	Sales
"Prepares financial reports for tax planning and compliance"	Finance
"Oversees IT project management and software rollouts"	IT
"Manages employee engagement surveys and follow-ups"	HR
"Leads negotiations for large-scale sales contracts"	Sales
"Conducts cash flow analysis for financial planning"	Finance
"Ensures network security and data encryption protocols"	IT
"Oversees employee training and development initiatives"	HR
"Manages client relationships to maximize sales opportunities"	Sales
"Monitors financial performance for profitability targets"	Finance
"Develops software solutions for business automation"	IT
"Handles employee exit processes and final settlements"	HR
"Develops sales strategies for long-term client retention"	Sales
"Prepares monthly financial reports for management review"	Finance
"Implements IT disaster recovery and backup plans"	IT
"Ensures compliance with health and safety regulations"	HR
"Oversees cross-functional sales and marketing projects"	Sales
"Conducts financial audits and prepares audit reports"	Finance
"Manages cloud computing and virtualized environments"	IT
"Coordinates employee performance appraisals and feedback"	HR
"Develops pricing strategies for global sales markets"	Sales
"Prepares financial budgets and variance analysis reports"	Finance
"Implements encryption and data loss prevention measures"	IT
"Leads employee mentorship and talent development programs"	HR
"Analyzes customer data to develop sales strategies"	Sales
"Prepares quarterly financial forecasts and business models"	Finance
"Implements software patches and security updates"	IT
"Handles employee grievances and mediation processes"	HR
"Monitors global sales trends and competitor performance"	Sales
"Oversees financial planning for international operations"	Finance
"Develops IT infrastructure to support business expansion"	IT
"Leads HR compliance initiatives and audits"	HR
"Manages CRM systems to improve sales efficiency"	Sales
"Analyzes financial data for corporate decision-making"	Finance
"Monitors IT service levels and system uptime"	IT
"Develops employee recognition programs to improve morale"	HR
"Oversees strategic partnerships to drive sales growth"	Sales
"Conducts financial due diligence for acquisitions"	Finance
"Implements IT policies to enhance data security"	IT
"Manages recruitment and hiring for critical roles"	HR
"Develops outbound sales strategies for global markets"	Sales
"Prepares financial risk assessments for management review"	Finance
"Monitors IT asset lifecycle and procurement processes"	IT
"Coordinates employee compensation and incentive programs"	HR
"Develops sales training programs for new hires"	Sales
"Performs variance analysis for financial forecasting"	Finance
"Maintains network performance and system availability"	IT
"Leads diversity and inclusion programs across departments"	HR
"Manages lead generation and sales funnel optimization"	Sales
"Prepares financial reports for regulatory compliance"	Finance
"Oversees software development lifecycle for IT projects"	IT
"Develops mobile applications and integrates APIs"	IT
"Monitors employee attendance and schedules"	HR
"Leads B2C sales and customer engagement strategies"	Sales
"Prepares financial forecasts for business expansion"	Finance
"Manages IT asset inventory and lifecycle"	IT
"Coordinates internal HR audits and compliance"	HR
"Develops customer loyalty programs to boost sales"	Sales
"Performs financial reconciliations for accuracy"	Finance
"Manages IT security audits and vulnerability assessments"	IT
"Oversees employee performance review processes"	HR
"Develops digital marketing strategies for sales growth"	Sales
"Prepares tax filings and ensures regulatory compliance"	Finance
"Implements cloud infrastructure for remote teams"	IT
"Handles employee relations and grievance processes"	HR
"Manages key account sales and client retention"	Sales
"Analyzes financial data to inform business decisions"	Finance
"Develops web-based applications and user interfaces"	IT
"Coordinates HR training for new managers"	HR
"Leads international sales efforts and partnerships"	Sales
"Prepares financial statements for quarterly reviews"	Finance
"Monitors IT system upgrades and hardware installations"	IT
"Manages employee disciplinary procedures"	HR
"Oversees sales lead generation and prospecting"	Sales
"Performs cost-benefit analysis for financial projects"	Finance
"Ensures IT infrastructure scalability for business growth"	IT
"Administers employee compensation reviews"	HR
"Develops social media marketing strategies for sales"	Sales
"Monitors cash flow to ensure financial stability"	Finance
"Implements secure communication networks"	IT
"Handles employee recruitment for leadership positions"	HR
"Leads digital sales campaigns for product launches"	Sales
"Prepares financial analysis for new product development"	Finance
"Manages cloud security protocols and audits"	IT
"Oversees HR data reporting and analytics"	HR
"Coordinates sales training workshops for teams"	Sales
"Develops financial forecasts for operational budgets"	Finance
"Troubleshoots server issues and performs data backups"	IT
"Handles employee legal compliance and labor laws"	HR
"Leads direct sales efforts and revenue growth initiatives"	Sales
"Performs risk analysis for financial planning"	Finance
"Monitors IT network security and firewall updates"	IT
"Coordinates employee feedback programs and action plans"	HR
"Develops sales incentives and commission structures"	Sales
"Prepares financial models for strategic planning"	Finance
"Manages enterprise software solutions and integrations"	IT
"Oversees HR policy development and updates"	HR
"Leads sales territory expansion strategies"	Sales
"Analyzes profitability margins for financial planning"	Finance
"Implements cybersecurity measures for cloud systems"	IT
"Manages employee training and onboarding for compliance"	HR
"Oversees sales operations for national accounts"	Sales
"Prepares quarterly and annual budget reports"	Finance
"Manages software licenses and compliance"	IT
"Develops talent acquisition strategies for recruitment"	HR
"Leads sales negotiations with key clients"	Sales
"Analyzes company finances for cost-saving opportunities"	Finance
"Monitors application security and vulnerability management"	IT
"Handles employee performance improvement programs"	HR
"Oversees cross-functional sales and marketing teams"	Sales
"Prepares financial statements for investor relations"	Finance
"Manages internal IT support for company-wide systems"	IT
"Coordinates HR projects for organizational development"	HR
"Leads sales process optimization and CRM management"	Sales
"Analyzes cash flow and financial liquidity"	Finance
"Monitors IT data centers and network operations"	IT
"Manages recruitment for technical positions"	HR
"Develops sales targets and revenue forecasting models"	Sales
"Prepares tax reports and manages compliance filings"	Finance
"Implements secure data access controls and encryption"	IT
"Handles employee training for conflict resolution"	HR
"Oversees sales pipeline management and forecasting"	Sales
"Monitors financial metrics and key performance indicators"	Finance
"Develops custom software tools for business automation"	IT
"Administers employee benefits and insurance programs"	HR
"Leads sales strategy for regional market expansion"	Sales
"Analyzes financial statements for year-end reporting"	Finance
"Implements data recovery strategies for IT systems"	IT
"Oversees HR onboarding for new employees"	HR
"Manages sales commissions and performance incentives"	Sales
"Prepares quarterly financial audits and compliance reports"	Finance
"Manages IT service management and issue resolution"	IT
"Develops HR policies for workplace diversity"	HR
"Oversees sales training for new product launches"	Sales
"Performs financial risk assessments for investments"	Finance
"Implements software updates and security patches"	IT
"Handles employee engagement and retention strategies"	HR
"Manages sales analytics and reporting systems"	Sales
"Prepares cash flow reports for senior management"	Finance
"Manages database performance and query optimization"	IT
"Oversees HR initiatives for employee well-being"	HR
"Develops global sales strategies for market penetration"	Sales
"Performs financial analysis for mergers and acquisitions"	Finance
"Develops cloud-based systems for business applications"	IT
"Coordinates employee performance appraisals and reviews"	HR
"Leads sales operations for international markets"	Sales
"Prepares variance analysis for financial forecasts"	Finance
"Implements IT infrastructure for business scalability"	IT
"Manages HR initiatives for employee development"	HR
"Oversees sales team performance and goal tracking"	Sales
"Analyzes financial trends for business growth"	Finance
"Develops IT disaster recovery and continuity plans"	IT
"Coordinates HR compliance with labor regulations"	HR
"Leads customer sales efforts for key accounts"	Sales
"Prepares financial statements for executive reporting"	Finance
"Monitors IT network latency and system performance"	IT
"Handles HR policy compliance and legal updates"	HR
"Manages digital sales campaigns and customer acquisition"	Sales
"Performs cost analysis for financial projections"	Finance
"Troubleshoots cloud-based systems and network issues"	IT
"Administers employee compensation and payroll systems"	HR
"Oversees sales pipeline growth and customer outreach"	Sales
"Prepares financial budgets and capital expenditure reports"	Finance
"Implements cybersecurity training for employees"	IT
"Handles employee exit interviews and feedback analysis"	HR
"Manages international sales and client relationships"	Sales
"Conducts financial forecasting for business expansion"	Finance
"Develops network protocols for secure communication"	IT
"Oversees employee wellness programs and initiatives"	HR
"Leads sales team on customer acquisition strategies"	Sales
"Prepares cash flow forecasts and financial models"	Finance
"Manages IT operations for enterprise environments"	IT
"Coordinates employee engagement surveys and reporting"	HR
"Develops sales strategies for long-term client growth"	Sales
"Analyzes financial reports for audit compliance"	Finance
"Implements automated systems for IT maintenance"	IT
"Handles employee grievances and dispute resolution"	HR
"Oversees sales planning for product launches"	Sales
"Prepares financial statements for annual reporting"	Finance
"Manages cloud infrastructure for business applications"	IT
"Oversees employee recruitment and talent acquisition"	HR
"Leads sales efforts for global expansion initiatives"	Sales
"Monitors financial transactions for accuracy and compliance"	Finance
"Implements software solutions for business processes"	IT
"Administers HR policies and employee handbook updates"	HR
"Oversees sales development for key account management"	Sales
"Prepares financial forecasts for operational efficiency"	Finance
"Monitors IT compliance with industry regulations"	IT
"Coordinates employee training and development programs"	HR
"Manages sales quotas and team performance tracking"	Sales
"Performs financial analysis for new business ventures"	Finance
"Implements network infrastructure for remote access"	IT
"Handles HR reporting and analytics for management"	HR
"Oversees B2B sales operations and client relations"	Sales
"Prepares financial budgets and spending reports"	Finance
"Develops IT systems for cross-functional collaboration"	IT
"Oversees employee learning and development initiatives"	HR
"Leads customer relationship management for key clients"	Sales
"Performs financial due diligence for new investments"	Finance
"Monitors cloud environments for security threats"	IT
"Handles employee recruitment and onboarding processes"	HR
"Develops digital sales strategies for online growth"	Sales
"Prepares financial analysis for revenue optimization"	Finance
"Manages IT infrastructure for remote work capabilities"	IT
"Oversees HR functions for global teams and offices"	HR
"Leads cross-functional sales initiatives for growth"	Sales
"Analyzes financial data to improve profit margins"	Finance
"Develops and optimizes machine learning models"	IT
"Handles employee dispute resolution and mediation"	HR
"Leads sales presentations and product demonstrations"	Sales
"Prepares annual financial statements and disclosures"	Finance
"Maintains and troubleshoots enterprise-level software"	IT
"Oversees employee compensation plans and negotiations"	HR
"Drives sales revenue through upselling and cross-selling"	Sales
"Conducts internal financial audits for compliance"	Finance
"Implements DevOps practices for continuous integration"	IT
"Handles performance evaluations and feedback cycles"	HR
"Leads sales campaigns to penetrate new markets"	Sales
"Performs financial analysis for profitability and loss"	Finance
"Monitors IT security breaches and incident responses"	IT
"Develops HR strategies to boost employee retention"	HR
"Manages sales targets for multi-product portfolios"	Sales
"Prepares budgets for department-level operations"	Finance
"Maintains cloud-based data storage and retrieval systems"	IT
"Administers employee training on corporate policies"	HR
"Develops sales promotions and discount campaigns"	Sales
"Performs financial modeling for business growth"	Finance
"Monitors software development for project timelines"	IT
"Handles talent acquisition for specialized roles"	HR
"Oversees sales team management and training"	Sales
"Prepares financial dashboards for executive decision-making"	Finance
"Manages disaster recovery planning for IT systems"	IT
"Coordinates employee relations programs and initiatives"	HR
"Develops CRM strategies for customer engagement"	Sales
"Monitors financial risks associated with investments"	Finance
"Implements network monitoring and alert systems"	IT
"Handles employee succession planning for leadership roles"	HR
"Leads the development of sales playbooks for teams"	Sales
"Analyzes cost structures to improve financial efficiency"	Finance
"Oversees IT hardware procurement and vendor relations"	IT
"Manages HR processes for promotions and transfers"	HR
"Develops sales pitches for high-value contracts"	Sales
"Monitors financial KPIs to optimize company growth"	Finance
"Develops enterprise resource planning systems"	IT
"Manages employee feedback loops and action plans"	HR
"Leads customer success initiatives to drive renewals"	Sales
"Analyzes financial health and liquidity for stakeholders"	Finance
"Implements virtualization technologies for server management"	IT
"Oversees compliance with workplace regulations"	HR
"Develops sales proposals for strategic partnerships"	Sales
"Prepares tax planning strategies for corporate finances"	Finance
"Monitors application performance and server logs"	IT
"Administers employee recognition and rewards programs"	HR
"Leads sales meetings and performance reviews"	Sales
"Analyzes quarterly financial reports for investor updates"	Finance
"Develops automated workflows for software deployment"	IT
"Handles diversity and inclusion programs for HR"	HR
"Oversees the sales strategy for premium clients"	Sales
"Monitors cash flow and financial liquidity management"	Finance
"Implements identity and access management systems"	IT
"Manages HR communications and policy updates"	HR
"Develops competitive pricing strategies for sales"	Sales
"Prepares variance reports on financial performance"	Finance
"Monitors database integrity and implements recovery plans"	IT
"Handles employee investigations and compliance issues"	HR
"Leads team sales efforts for market growth"	Sales
"Analyzes cost-benefit scenarios for financial planning"	Finance
"Implements secure coding practices for application development"	IT
"Oversees workforce planning and talent analytics"	HR
"Develops sales onboarding materials for new hires"	Sales
"Prepares reports on revenue forecasting and trends"	Finance
"Manages IT budgets and resource allocation"	IT
"Coordinates HR initiatives for mental health awareness"	HR
"Leads sales initiatives for customer retention"	Sales
"Analyzes financial data for profitability insights"	Finance
"Implements cloud architecture for scalable applications"	IT
"Handles employee leave requests and benefits administration"	HR
"Develops sales strategies for niche markets"	Sales
"Monitors financial markets to inform company investments"	Finance
"Implements secure mobile device management solutions"	IT
"Oversees the development of internal HR policies"	HR
"Leads sales teams in achieving monthly targets"	Sales
"Prepares financial statements for regulatory audits"	Finance
"Manages IT service level agreements and vendor contracts"	IT
"Handles employee engagement surveys and analysis"	HR
"Develops sales lead generation tools and processes"	Sales
"Performs financial forecasting for revenue growth"	Finance
"Implements scalable cloud storage solutions for the enterprise"	IT
"Oversees employee development programs and career paths"	HR
"Leads sales negotiation efforts for enterprise deals"	Sales
"Monitors corporate tax compliance and reporting"	Finance
"Implements data privacy and compliance regulations"	IT
"Administers employee recognition awards and initiatives"	HR
"Oversees the management of customer accounts"	Sales
"Prepares financial models for cost reduction strategies"	Finance
"Implements AI-driven automation for IT processes"	IT
"Manages employee diversity and inclusion programs"	HR
"Leads market research initiatives for new sales opportunities"	Sales
"Monitors financial health and develops risk mitigation plans"	Finance
"Oversees the migration of legacy systems to the cloud"	IT
"Handles employee conflict resolution and mediation"	HR
"Develops sales plans for international market expansion"	Sales
"Analyzes financial ratios to guide company investments"	Finance
"Implements ITIL framework for IT service management"	IT
"Oversees employee morale and workplace satisfaction initiatives"	HR
"Leads customer relationship management projects for sales"	Sales
"Prepares financial projections for mergers and acquisitions"	Finance
"Implements API integrations for third-party services"	IT
"Handles recruitment for senior-level positions"	HR
"Develops sales strategies for long-term contracts"	Sales
"Monitors cash flow to improve operational efficiency"	Finance
"Implements multi-factor authentication for security"	IT
"Oversees employee onboarding for remote hires"	HR
"Leads sales strategy for product diversification"	Sales
"Analyzes profit margins and cost optimization opportunities"	Finance
"Manages IT operations for hybrid cloud environments"	IT
"Handles HR planning for succession and retention"	HR
"Develops sales quotas and compensation structures"	Sales
"Prepares quarterly financial reports for shareholders"	Finance
"Implements cybersecurity best practices for data protection"	IT
"Oversees talent acquisition strategies for niche roles"	HR
"Leads outbound sales efforts for high-growth products"	Sales
"Monitors financial performance for strategic investments"	Finance
"Manages IT infrastructure for enterprise applications"	IT
"Coordinates leadership development programs for employees"	HR
"Develops targeted sales strategies for key markets"	Sales
"Prepares tax compliance reports for government filings"	Finance
"Implements cloud-based collaboration tools for teams"	IT
"Handles workplace investigations and conflict resolution"	HR
"Leads sales efforts for new customer acquisitions"	Sales
"Analyzes financial risks to inform investment decisions"	Finance
"Develops software integration solutions for business needs"	IT
"Oversees the creation of employee learning programs"	HR
"Leads direct sales efforts for high-value contracts"	Sales
"Monitors financial health and prepares risk management plans"	Finance
"Implements secure networking solutions for remote workforces"	IT
"Handles employee grievances and workplace concerns"	HR
"Leads B2B sales efforts for strategic partnerships"	Sales
"Prepares financial forecasts to guide budgeting decisions"	Finance
"Develops cloud-based infrastructure for scalable IT systems"	IT
"Manages HR initiatives to enhance company culture"	HR
"Leads sales team training on negotiation tactics"	Sales
"Monitors key financial metrics to ensure company growth"	Finance
"Implements data encryption and secure access protocols"	IT
"Oversees workforce management and talent development"	HR
"Develops sales campaigns to increase product awareness"	Sales
"Prepares cash flow statements for financial reporting"	Finance
"Implements remote monitoring solutions for IT infrastructure"	IT
"Handles employee exit strategies and retirement plans"	HR
"Leads digital marketing strategies to boost sales"	Sales
"Monitors financial planning to improve cash flow"	Finance
"Develops IT security policies and risk management plans"	IT
"Oversees training programs for leadership development"	HR
"Leads customer outreach efforts for repeat business"	Sales
"Prepares financial summaries for quarterly earnings calls"	Finance
"Implements disaster recovery solutions for business continuity"	IT
"Manages HR compliance with local and international labor laws"	HR
"Develops sales forecasts and market analysis reports"	Sales
"Analyzes financial reports for accuracy and compliance"	Finance
"Implements infrastructure for high-availability IT systems"	IT
"Handles employee relations for multi-national teams"	HR
"Leads product marketing efforts to drive sales"	Sales
"Prepares budgets and financial reports for management"	Finance
"Develops software solutions for internal tools"	IT
"Manages employee wellness programs and activities"	HR
"Leads outbound sales initiatives to acquire new clients"	Sales
"Prepares financial reports for stakeholders and investors"	Finance
"Monitors IT infrastructure performance and uptime"	IT
"Oversees employee development plans and performance tracking"	HR
"Leads sales efforts in expanding market share"	Sales
"Analyzes cost-saving opportunities within financial budgets"	Finance
"Develops mobile applications for company use"	IT
"Handles HR policies and compliance with labor laws"	HR
"Leads sales outreach for prospective customers"	Sales
"Monitors financial performance to ensure revenue growth"	Finance
"Implements IT security protocols for business operations"	IT
"Oversees employee recognition and retention strategies"	HR
"Develops sales tactics to close high-value deals"	Sales
"Prepares tax filings and manages corporate tax compliance"	Finance
"Monitors network security and vulnerability assessments"	IT
"Handles employee feedback processes and surveys"	HR
"Develops lead generation strategies to boost sales pipeline"	Sales
"Monitors cash flow to maintain financial stability"	Finance
"Implements cloud migration strategies for business systems"	IT
"Oversees employee onboarding and training programs"	HR
"Leads the sales strategy for key accounts and partnerships"	Sales
"Analyzes financial data for operational improvements"	Finance
"Develops software deployment processes for production systems"	IT
"Manages employee relations and conflict resolution processes"	HR
"Leads cross-functional sales teams for strategic initiatives"	Sales
"Prepares quarterly financial statements for review"	Finance
"Implements secure network architecture for company IT systems"	IT
"Oversees HR communications and internal messaging"	HR
"Develops customer engagement strategies to increase sales"	Sales
"Analyzes profit margins for business cost optimization"	Finance
"Monitors application performance and user experience"	IT
"Handles recruitment for specialized technical positions"	HR
"Leads negotiations with clients for large sales contracts"	Sales
"Monitors financial compliance and regulatory standards"	Finance
"Implements cloud-native applications for business functions"	IT
"Oversees employee talent management and career development"	HR
"Develops sales forecasts for upcoming business quarters"	Sales
"Prepares audit reports for internal and external review"	Finance
"Manages IT disaster recovery and continuity planning"	IT
"Handles employee training on diversity and inclusion"	HR
"Leads sales strategy for regional markets and territories"	Sales
"Analyzes financial forecasts to guide business investments"	Finance
"Implements enterprise software solutions for company-wide use"	IT
"Manages HR data analytics and workforce planning"	HR
"Develops incentive programs to boost sales performance"	Sales
"Monitors company tax obligations and ensures compliance"	Finance
"Implements IT infrastructure for remote work support"	IT
"Handles employee compensation plans and benefit structures"	HR
"Leads customer satisfaction efforts to drive repeat sales"	Sales
"Prepares financial plans for capital expenditure projects"	Finance
"Implements data security practices for cloud services"	IT
"Oversees HR performance management and reviews"	HR
"Leads outbound sales efforts for corporate partnerships"	Sales
"Monitors financial metrics to optimize business efficiency"	Finance
"Implements software updates and system patches"	IT
"Handles recruitment for leadership and executive roles"	HR
"Develops sales training programs for new hires"	Sales
"Analyzes cash flow reports to maintain financial health"	Finance
"Monitors IT compliance with industry standards and regulations"	IT
"Oversees employee engagement programs and surveys"	HR
"Leads sales strategy for B2B markets and services"	Sales
"Prepares budget allocations for department expenditures"	Finance
"Implements hybrid cloud environments for business applications"	IT
"Handles employee relations and policy enforcement"	HR
"Leads account management efforts to maintain customer relationships"	Sales
"Monitors revenue growth and financial performance indicators"	Finance
"Develops automated processes for software testing"	IT
"Manages HR initiatives for employee career advancement"	HR
"Leads sales efforts for product launches and promotions"	Sales
"Prepares financial dashboards for executive leadership"	Finance
"Implements secure data storage solutions for sensitive information"	IT
"Oversees HR policy development and implementation"	HR
"Leads customer service efforts to drive customer loyalty"	Sales
"Analyzes financial statements to assess business performance"	Finance
"Implements cloud infrastructure for scalable IT operations"	IT
"Handles employee wellness initiatives and mental health programs"	HR
"Develops sales strategies for new customer acquisition"	Sales
"Monitors cash flow and liquidity for business operations"	Finance
"Implements virtual desktop solutions for remote teams"	IT
"Oversees talent acquisition for technical positions"	HR
"Leads sales efforts to achieve quarterly revenue targets"	Sales
"Analyzes financial reports to guide business decisions"	Finance
"Implements encryption standards for data protection"	IT
"Manages HR systems for employee information and payroll"	HR
"Develops sales plans to penetrate competitive markets"	Sales
"Monitors financial risks to ensure business continuity"	Finance
"Implements automation tools for IT management tasks"	IT
"Handles employee relations for global teams and offices"	HR
"Leads sales efforts for large enterprise contracts"	Sales
"Prepares financial reports for operational improvements"	Finance
"Implements secure communication protocols for remote workforces"	IT
"Oversees HR compliance with regulatory standards"	HR
"Leads customer retention efforts to boost repeat sales"	Sales
"Monitors revenue and profitability for business divisions"	Finance
"Implements cloud-based tools for team collaboration"	IT
"Handles employee grievances and conflict resolution"	HR
"Develops pricing strategies for competitive sales markets"	Sales
"Monitors financial performance for cost-saving opportunities"	Finance
"Implements software security updates and compliance patches"	IT
"Oversees workforce planning and succession strategies"	HR
"Leads the sales team in meeting yearly revenue targets"	Sales
"Analyzes financial data to improve profit margins"	Finance
"Implements secure file sharing solutions for business operations"	IT
"Manages employee training on HR policies and procedures"	HR
"Develops customer loyalty programs to drive repeat business"	Sales
"Prepares cash flow reports for management review"	Finance
"Implements monitoring systems for IT network performance"	IT
"Handles employee training on workplace safety regulations"	HR
"Leads direct sales efforts for premium client acquisition"	Sales
"Analyzes quarterly financial results to assess business growth"	Finance
"Implements AI-driven analytics for business operations"	IT
"Oversees recruitment strategies for diverse talent pools"	HR
"Leads sales presentations for potential clients and partners"	Sales
"Prepares tax strategies to optimize company savings"	Finance
"Implements automated systems for cybersecurity monitoring"	IT
"Manages employee benefit programs and compensation packages"	HR
"Leads sales efforts for international markets and expansion"	Sales
"Monitors budget allocations for business operations"	Finance
"Implements cloud-based ERP systems for business management"	IT
"Handles employee recruitment for remote roles and positions"	HR
"Leads sales training initiatives for new sales hires"	Sales
"Prepares financial forecasts for long-term business planning"	Finance
"Implements secure mobile device management solutions for IT"	IT
"Oversees employee engagement and retention programs"	HR
"Leads account management strategies for customer success"	Sales
"Monitors financial reports to ensure accuracy and compliance"	Finance
"Implements automated backup solutions for critical data"	IT
"Handles employee disputes and workplace investigations"	HR
"Leads sales outreach to generate new business leads"	Sales
"Prepares financial reports for external audits and reviews"	Finance
"Implements disaster recovery solutions for business operations"	IT
"Manages employee communication channels and HR support"	HR
"Leads sales efforts to expand company revenue streams"	Sales
"Monitors financial statements to improve business performance"	Finance
"Implements AI-driven software solutions for IT operations"	IT
"Oversees training programs to enhance employee skills"	HR
"Leads product marketing efforts to drive sales growth"	Sales
"Analyzes cash flow statements to maintain financial health"	Finance
"Implements cloud-native solutions for scalable business operations"	IT
"Handles employee recruitment for technical and engineering roles"	HR
"Develops sales quotas and performance metrics for sales teams"	Sales
"Prepares financial statements for internal and external use"	Finance
"Implements network monitoring tools for IT infrastructure"	IT
"Manages HR initiatives to improve employee engagement"	HR
"Leads digital sales efforts to reach online customers"	Sales
"Monitors financial health to ensure company profitability"	Finance
"Implements advanced cybersecurity practices to protect data"	IT
"Develops technical documentation for software applications"	IT
"Manages employee attendance tracking and reporting"	HR
"Leads sales presentations for high-profile clients"	Sales
"Analyzes financial risks and prepares mitigation strategies"	Finance
"Oversees IT hardware procurement and inventory management"	IT
"Handles employee disciplinary actions and resolutions"	HR
"Develops new customer outreach strategies"	Sales
"Prepares financial statements for annual reporting"	Finance
"Implements data encryption protocols to secure company information"	IT
"Oversees employee assistance programs"	HR
"Leads negotiations for enterprise-level sales contracts"	Sales
"Analyzes financial ratios to assess company profitability"	Finance
"Develops IT systems for interdepartmental communication"	IT
"Manages HR legal compliance and employment law issues"	HR
"Leads B2B sales efforts to generate new business"	Sales
"Prepares financial projections for future investments"	Finance
"Implements remote access solutions for offsite employees"	IT
"Handles employee exit interviews and data analysis"	HR
"Develops sales playbooks and training materials"	Sales
"Monitors financial performance against business objectives"	Finance
"Develops software integrations for third-party applications"	IT
"Oversees HR project management and initiatives"	HR
"Leads cross-selling strategies to boost client engagement"	Sales
"Analyzes cash flow to manage liquidity"	Finance
"Implements disaster recovery plans for critical IT systems"	IT
"Manages employee travel and expense reporting"	HR
"Develops sales forecasts for product lines"	Sales
"Prepares financial reports for management decisions"	Finance
"Implements IT systems for customer support and ticketing"	IT
"Handles HR data privacy and confidentiality issues"	HR
"Leads direct sales initiatives for target markets"	Sales
"Monitors financial performance and prepares risk assessments"	Finance
"Implements IoT solutions for improved business efficiency"	IT
"Manages employee onboarding experience and support"	HR
"Develops sales plans for new market entries"	Sales
"Prepares quarterly tax filings and payments"	Finance
"Implements IT automation for routine system tasks"	IT
"Handles HR communications and internal announcements"	HR
"Leads sales efforts for high-margin products and services"	Sales
"Monitors company expenses and identifies cost-cutting opportunities"	Finance
"Implements data visualization tools for business analysis"	IT
"Manages HR software systems and integrations"	HR
"Develops targeted sales campaigns to attract new business"	Sales
"Analyzes revenue trends to optimize profitability"	Finance
"Implements system monitoring tools for cybersecurity"	IT
"Oversees HR reporting on employee performance and retention"	HR
"Leads the sales team in achieving quarterly goals"	Sales
"Prepares financial statements for budget planning"	Finance
"Implements IT best practices for system optimization"	IT
"Handles employee benefits administration and compliance"	HR
"Develops sales presentations for prospective clients"	Sales
"Analyzes financial data to prepare investment strategies"	Finance
"Implements remote work tools and infrastructure"	IT
"Manages HR performance evaluation systems"	HR
"Leads cross-functional sales efforts with marketing"	Sales
"Prepares cost-benefit analyses for business projects"	Finance
"Implements cybersecurity measures to prevent data breaches"	IT
"Handles HR strategic planning and workforce analytics"	HR
"Develops sales incentives to drive team performance"	Sales
"Monitors financial performance and recommends cost reductions"	Finance
"Implements AI-driven IT tools for business automation"	IT
"Oversees employee engagement and satisfaction surveys"	HR
"Leads the sales team in identifying key business opportunities"	Sales
"Analyzes cash flow statements for business forecasting"	Finance
"Implements server virtualization for IT efficiency"	IT
"Handles HR training programs for employee skill development"	HR
"Leads sales efforts for high-demand product offerings"	Sales
"Monitors tax compliance and prepares filings"	Finance
"Implements cloud solutions for business data storage"	IT
"Oversees employee succession planning and career development"	HR
"Leads business development efforts to attract new clients"	Sales
"Prepares financial models for business analysis"	Finance
"Implements cybersecurity solutions for data integrity"	IT
"Handles employee rewards programs to boost retention"	HR
"Leads strategic sales planning for company growth"	Sales
"Analyzes budget performance to optimize resources"	Finance
"Implements network security measures for external threats"	IT
"Manages HR audits and ensures regulatory compliance"	HR
"Leads direct marketing sales campaigns to boost revenue"	Sales
"Prepares financial reports for external stakeholders"	Finance
"Implements IT governance and compliance processes"	IT
"Handles employee orientation and training schedules"	HR
"Leads cross-selling initiatives to expand customer base"	Sales
"Analyzes financial ratios for business decision-making"	Finance
"Implements data governance policies for IT systems"	IT
"Oversees employee health and wellness initiatives"	HR
"Leads sales efforts for major enterprise clients"	Sales
"Prepares financial reports for investor presentations"	Finance
"Implements data security protocols for sensitive information"	IT
"Handles employee engagement surveys and results analysis"	HR
"Develops sales proposals for high-profile clients"	Sales
"Analyzes financial performance to ensure profitability"	Finance
"Implements cloud computing for business scalability"	IT
"Oversees employee compensation analysis and benchmarking"	HR
"Leads sales outreach for customer acquisition"	Sales
"Monitors business budgets for operational efficiency"	Finance
"Implements backup systems for critical business data"	IT
"Handles HR communications and employee feedback programs"	HR
"Leads sales efforts to expand product lines and services"	Sales
"Prepares financial audits for internal review"	Finance
"Implements IT solutions for enterprise resource planning"	IT
"Manages HR records and compliance with industry standards"	HR
"Develops sales strategies for key client accounts"	Sales
"Analyzes company financial data for performance optimization"	Finance
"Implements network infrastructure upgrades for scalability"	IT
"Oversees HR initiatives to promote workplace diversity"	HR
"Leads sales efforts for high-value corporate clients"	Sales
"Prepares financial analysis for business risk management"	Finance
"Implements virtual environments for software testing"	IT
"Handles employee development plans and mentoring programs"	HR
"Leads sales efforts to improve customer retention"	Sales
"Analyzes revenue data to identify new growth opportunities"	Finance
"Implements IT policies for business continuity"	IT
"Manages HR onboarding processes for new hires"	HR
"Leads direct sales efforts for competitive markets"	Sales
"Prepares financial plans for capital investments"	Finance
"Implements secure communication systems for business operations"	IT
"Handles employee recognition programs for performance achievements"	HR
"Leads sales efforts for new product launches"	Sales
"Monitors financial systems for fraud detection and prevention"	Finance
"Implements IT solutions for business process automation"	IT
"Oversees employee satisfaction and retention metrics"	HR
"Leads sales initiatives for new client acquisition"	Sales
"Prepares budget forecasts for future business growth"	Finance
"Implements virtual desktop environments for remote employees"	IT
"Handles HR policy updates and employee communications"	HR
"Leads the sales team in achieving annual revenue goals"	Sales
"Analyzes financial data to create cost-saving strategies"	Finance
"Implements security measures for IT systems and data"	IT
"Oversees employee development programs for career progression"	HR
"Leads digital marketing sales efforts for online customers"	Sales
"Prepares cash flow projections for business planning"	Finance
"Implements automated processes for IT infrastructure management"	IT
"Handles HR recruitment for critical business roles"	HR
"Leads the sales team in closing high-value contracts"	Sales
"Analyzes budget performance to optimize business operations"	Finance
"Implements IT solutions for real-time data monitoring"	IT
"Oversees HR performance reviews and goal setting"	HR
"Leads product demonstrations for prospective customers"	Sales
"Monitors financial performance to ensure operational efficiency"	Finance
"Implements data encryption for secure information transfer"	IT
"Handles employee compensation reviews and adjustments"	HR
"Develops customer service sales strategies to improve retention"	Sales
"Analyzes revenue data to improve financial performance"	Finance
"Implements network security for business-critical applications"	IT
"Oversees HR metrics for employee engagement and retention"	HR
"Leads sales efforts to expand into new regions"	Sales
"Prepares financial reports for annual audit reviews"	Finance
"Implements cloud infrastructure for enhanced scalability"	IT
"Handles HR employee development and coaching programs"	HR
"Leads sales outreach for top-tier clients and partners"	Sales
"Monitors financial risks and develops mitigation plans"	Finance
"Implements software development lifecycle best practices"	IT
"Manages employee feedback and performance metrics"	HR
"Develops strategic partnerships to enhance sales opportunities"	Sales
"Prepares monthly financial reconciliations and analysis"	Finance
"Implements IT solutions for customer relationship management"	IT
"Handles HR training for diversity and inclusion"	HR
"Leads the sales team in expanding product distribution"	Sales
"Analyzes expense reports to identify savings opportunities"	Finance
"Implements mobile device management solutions for security"	IT
"Oversees employee morale and workplace culture initiatives"	HR
"Develops targeted sales initiatives for underperforming products"	Sales
"Prepares annual financial budgets for departmental review"	Finance
"Implements IT security policies for remote access"	IT
"Handles HR issues related to employee grievances"	HR
"Leads account management strategies for existing clients"	Sales
"Monitors compliance with financial regulations and standards"	Finance
"Implements software for business intelligence and reporting"	IT
"Manages HR processes for employee onboarding and orientation"	HR
"Develops sales training programs for new hires"	Sales
"Prepares year-end financial reports for stakeholders"	Finance
"Implements IT training programs for end-users"	IT
"Handles HR functions related to employee engagement initiatives"	HR
"Leads competitive analysis to inform sales strategies"	Sales
"Analyzes budget variances and prepares reports for management"	Finance
"Implements virtualization technology for server management"	IT
"Oversees HR communications for organizational changes"	HR
"Leads the sales team's efforts in upselling to existing clients"	Sales
"Prepares financial summaries for quarterly business reviews"	Finance
"Implements IT systems for inventory and supply chain management"	IT
"Handles employee wellness programs and initiatives"	HR
"Develops pricing strategies to improve sales profitability"	Sales
"Analyzes profitability of business segments for management"	Finance
"Implements end-user training for IT tools and software"	IT
"Manages HR functions related to employee retention strategies"	HR
"Leads customer relationship management efforts to enhance loyalty"	Sales
"Prepares financial models for capital expenditure analysis"	Finance
"Implements cloud computing solutions to improve scalability"	IT
"Conducts employee satisfaction surveys to inform management decisions"	HR
